1111111111111
10C10000000C1
100001000C001
1P0C01E000001
1111111111111