111111111111111
1CCCCCCCCCCCCC1
1PCCCCC0CCCCCC1
1ECCCCCCCCCCCC1
111111111111111