111111111
10CEP0001
100000011
111111111